NO ./img/wall_north.xpm
SO ./img/wall_south.xpm
WE ./img/wall_west.xpm
EA ./img/wall_east.xpm

F 220,100,0
C 225,30,0

11111111111111111111111111
1000000000110000000000001
1011000001110000000000001
10010000000000000000000111111111
111111111011000001110000000000001
100000000011000001D10111011111111
11110111111111011100000010001
11110111111111011101010010001
11000000110101011100000010001
10000000000000001100000010001
10000000000000001101010010001
11000001110101011111011110N0111
11110111 1110101 101111010001
11111111 1111111 111111111111
