NO ./img/wall_north.xpm
SO ./img/wall_south.xpm
WE ./img/wall_west.xpm
EA ./img/wall_east.xpm

F 220,100,0
C 225,30,0

     11111111
    1     1  1
 1111     1  1
    1   N  1 1
     11111111
